11111111111111111111111111111
14000000000000000000000000041
10111111011111111111011111101
10000041000000000000014000001
10111101011111011111010111101
10000101000000000000010100001
10110101011111011111010101101
10000100000000000000000100001
10110101010111311101010101101
200000010101g333g101010101102
201101010101g333g101010000002
10110101010111111101010101101
10000100000000000000000100001
10110101011111011111010101101
10000101000000000000010100001
10111101011111011111010111101
10000041000000000000014000001
10111111011111111111011111101
14000000000000p00000000000041
11111111111111111111111111111